EWEEEEEEEE
EEEEEEEEEE
EEWEEEEEEE
EEEEEEEAEE
EEEEEEEEEE
EEEEEEETEE
EEEWEEEEEE
EWEEEEEEEE
EEEEWEEEEE
DEEWEEEEEE