EWEEEEEEEE
EEEEEEEEEE
EEWEEEEEEE
EEEEEEEAEE
EEEEEEEEE
EEEEEEEEEE
EEEWEEEEEE
EWEEEEEEEE
EEEEWEEEEE
DEEWEEEEEE