EWEEEEEEEE
EEEEEEEEEE
WWWEEEEEEE
EEWEEEEAEE
EEEEEEEEEE
EEWEEEEEEE
EEWWEEEEEE
EEWEEEEEEE
EEWEWEEEEE
EEEEEEEEEE
EEEEEEEEEE
