EWEEEEEEEE
EEEEEEEEEE
WWWEEEEEEE
EEWEEEEEEE
EEEEEEEEEE
EEWEEEEEEE
EEWWEEEEEE
EEWEEEEEEE
EEWEWEEEEE
EDEEEEEEEE
EEEEEEEEEE
